XXXXXXXXXXXX
X.....X..XeX
X.XXX.X.XX.X
X.X.X.X.XX.X
X.X.X.X..X.X
X.X.X.XX.X.X
XsX........X
XXXXXXXXXXXX